There Must Be More Than Blood - Car Seat Headrest
Closer - The Feather (official)
VANILLE FRAISE (edit) - L'Imp\u00e9ratrice
Dollar (20syl Remix) - Electric Guest
Hey You - Cedric Gervais Vs Dope Lemon
Speedracer (Falcon Punch Remix) - Capyac
Speedracer - CAPYAC
Dirty - CAPYAC
In This Moment - Hot Tub
Thank You (Not So Bad) - Felix Jaehn
Roller Disco 1980 (feat. Hi Levelz) - The Geek x Vrv
Robin Hood (Deluxe Version) - Sam Sun
Us - tiny deaths
Wut - Girl Unit
West Coast Love - Emotional Oranges
Apollo - Tourist
everything i wanted (paul mond & tera k\u00f2r\u00e1 flip) - billie eilish
Sippin - FloFilz
The Summer - Freedom Fry
Lisztomania (Shook Remix) - Phoenix
Vitalik Buterin - Gramatik & Kotek
Weapons For Children - Peturbator
OUTTA MY MIND - monsune
California Love (Psymbionic Remix) [ - 2pac ft. Dr Dre
Luniz- I Got 5 On It (Maars Reggae Re-Fix) - DJ MAARS
I Got 5 On It (remix with E-40) - Luniz
Too Many Lies (LEFTI Remix) - La Felix
Run Wild - PLS&TY
Run Wild (Manic Focus Remix) - PLS&TY
Johannesburg (feat. Gruff Rhys - Africa Express
Ellipsis - Drab Majesty
PATTERNS (feat. Sara Diamond) - NASAYA
All In My Head feat. Desire\u0301e Dawson - Pat Lok
Underwater (Willaris. K Remix) - R\u00dcF\u00dcS DU SOL
Your Love (feat. Neigh) - Caius
rock it - Sub Focus
Someone Else - Emotional Oranges
Feels (Justice Skolnik Remix) - Calvin Harris
Mockingbird - Wild Belle
Just Like You - Satin Jackets
Violet City - MANSIONAIR
Me and Michael - MGMT
A Brand New Day (feat. ASM & Balkan Bump) - Poldoore
What Lana Says - ProleteR
I Wanna Know (Justice Skolnik Remix) - RL Grime
Juice - Lizzo
Hollywood (feat. Snoop Dogg & Jamie Principle) - Gorillaz
Sorcererz - Gorillaz
Sesame Syrup - Cigarettes After Sex
SOBER - daste.
jasmine (ilo ilo rework) - jai paul
Heaven - Weval
Lay Back (bad tuner remix) - bad tuner
Breathless (Like This) - Loveday x PYNGU
Just Jammin' (Original Mix) - Gramatik
Wonderland - Jinka
Ghost 2 U - Jinka
Aiming Up (Moods Remix) - Two Another
City of Sound - Big Wild
Hopes Up - DRAMA DUO
Pops - THEY.
What I Know Now (feat. Wiz Khalifa) - THEY.
BITTER END - YOUNG & SICK
Cream - Falcon Punch
There's No Love - Moon Boots
king - slenderbodies
Afterthought - Slum Sociable
Undo (feat. Jeremih & Tory Lanez) (AWAY Remix) - RL Grime
Take Me Over feat. SAFIA (NEUS Remix) - Peking Duk
Ratatat x Tupac Mashup - DJ Tip-Z
Drops - FKJ feat. Tom Bailey
Navajo - Masego
Tadow (feat. FKJ) - Masego
Ultimatum (feat. Fatoumata Diawara) - Disclosure
All Night - Parov Stelar
Books of War (Prod. by Omegah Red aka Poison Flowerz) - MF DOOM & RZA
Rapp Snitch Knishes (Feat. Mr. Fantastik) - MF Doom
Forever - Painted Palms
OMG!!! - YELLE
Smooth - Laster
So Electric - Lifelike
Tieduprightnow - Parcels
Ghost - Whirr
Dark All Day (feat. Tim Cappello & Indiana) - GUNSHIP
No Devotion - TENDER
Irre\u0301versible (Private Agenda Remix) - Fhin
Are You All Good - breathe.
You're On feat. Kyan (Oliver Remix) - Madeon
Imperium (Dillon Francis Remix) - Madeon
Pop Culture (Live Mashup) - Madeon
Live In The Moment (PLS&TY Remix) - Portugal. The Man
Otherside (Two Friends Remix) - Red Hot Chili Peppers
Humble (Skrillex Remix) - Kendrick Lamar
La Felix- Get To You (feat. Joshua Moriarty) (Funk LeBlanc Remix) - La F\u00e9lix
A Pill To Crush - Evalyn
One - Bronze Whale
amnesia - slenderbodies
toxic (britney spears cover) - slenderbodies
Loyal - ODESZA
1nce Again (Rhythm Scholar AtariFunk 8-Bit Remix) (Explicit) - A Tribe Called Quest
Hard To Win - Bahwee
Good Thing - Henry Nowhere
Wilde as Me - My Ultra Violet
Islands - My Ultra Violet
Siren - Kailee Morgue
Love$ick (feat. A$AP Rocky) - Mura Masa
Soy Bonita Feat. Marcy Chin (Shan Remix) - French Horn Rebellion
This Is My Cue - Eliza Shaddad
Way Too Fly (feat. DaVido) - A BOOGIE WIT DA HOODIE
Forgive feat. Washed Out - ROOSEVELT
Personal - Emotional Oranges
Don't You Forget About Me - T-E-E-D
Trance Dance - ODIE
My Life (AWAY Remix) - ZHU & Tame Impala
Say My Name (Cosmo's Midnight Bootleg) - Destiny's Child
Falling Out (feat. Lido) - Cosmo's Midnight
The Dofflin (Wave Racer Remix) - Cosmo's Midnight
My Enemy (feat. Matt Berninger) - CHVRCHES
A Little Bit Of Trouble - TEMPESST
I Found Heaven - MARY MILLER
Get Out - Mickey Kojak
Love Lies (Medasin Remix) - Khalid & Normani
blue pill (feat. SARAI) - JVLY
BRAINFLOWER - TASH SULTANA
Take It From Me - Satin Jackets feat. Emma Brammer
Colder Than Ice - POND
Dream Reader - FRANKIIE
Feel Good (feat. Khruangbin) (Edit) - Maribou State
Motion - Emotional Oranges
Let It Happen - Tame Impala
Keep On Loving You - Cigarettes After Sex
Pretty Girl (Whethan Bootleg) - Clairo
Eventually - Tame Impala
The Less I Know The Better Vinyl - Tame Impala
1985 - J. Cole & DJ Premier
Wait For Love - Cam Maclean
Low Beam - Her's
After The Storm (feat. Tyler - Kali Uchis
Finesse - Elgus
Control (feat. Jerry Folk) - Lemaitre
Just Werrrk - French Horn Rebellion & Jody Watley
Dalmatians - Opiuo
Sinner (feat. Kweku Collins  - Ric Wilson
Left & Right  - Bluestaeb
Hey Kids (Feat. Late Verlane) - Molina
The Blacker The Berry (Explicit) - Kendrick Lamar
Ride (feat. Rush Davis) (Lenno Remix) - NIK\u00d6 BLANK
All Yours - APRE
The Day I Die - ISLAND
got urself an electric gun (nas vs mgmt & justice) - Wait What
electric feel (mgmt cover) - slenderbodies
Sweater Weather (Little Daylight Remix) - The Neighbourhood
Supermoon - Break Science
Memory Pools - Foxes in Fiction
Ancient Names (Part I) - Lord Huron
DNA. (Yung Bae Remix) - Kendrick Lamar
Hypnotic (solidisco Remix) - Zella Day
1965 - Zella Day
High - Vanic X Zella Day
Back Of Your Car - Swimming Girls
Night By Night (Callback Funk Remix) - Chromeo
Nurse Ratched - Cherry Glazerr
Breakadawn - Fela Soul
Hold On (feat. IVYE) - Klune
Strangers (LUXXURY Remix) - The Ramona Flowers
Favourite Song - pizzagirl
Reims - RL Grime
Dust - M.O.O.N.
Dust (Carpenter Brut Remix) - M|O|O|N
Running Away (feat. CUT_) - Taska Black x DROELOE
Miss Brand New (Mountain Bird Remix) - Tingsek
The Celebration Song - Brock Berrigan
Roll in Peace (feat. Migos)(REMIX) - Gucci Mane
Restless Sea (feat. Opia) - Louis Futon
Sunburn - DROELOE
Party Down - Freedom Fry
This Is Not A Love Song - B\u00fclow
Bring The Funk Back (The Geek x Vrv Remix) - Big Gigantic
Silence (Lost Kings Remix) - Marshmello feat. Khalid
Green Light (Chromeo Remix) - Lorde
Put Jewels On it feat. Run The Jewels - Statik Selektah
Mistakes - Tove Styrke
Moments Passed - Dermot Kennedy
Over U (feat. Yeah Boy) - Enschway
Catalina Dice feat. Boulevards - French Horn Rebellion & Bee's Knees
Sunset Lover (Slow Hours Remix) - PETIT BISCUIT
Look At Us Now (feat. Ally Brooke & A$AP Ferg) - Lost Kings
Me & You (feat. Helen Tess) - KVMO
Apocalypse - Cigarettes After Sex
Light - San Holo
Don't Leave (Gryffin Remix) - Snakehips & M\u00d8
Skewed Empathy (Skratch Bastid Mix) - Crystal Castles & Outkast & Raekwon
Roses (PLS&TY Remix) - OutKast
Roses - Outkast
Mad About You - Koni feat. Danelle
Holding You (Stan Sax Edit) - Slowz
Falling (Wheathin Redo) - Opia
HEAT (feat. Sam Nelson Harris) (Manila Killa Remix) - The Knocks
My Mind - Midnight Club
Redbone - Childish Gambino
K. - Cigarettes After Sex
In the Name Of Love feat. Bebe Rexha (The Him Remix) - Martin Garrix
Starboy (Kygo Remix) - The Weeknd & Daft Punk
Swimming (JNTHN STEIN Remix) (feat James Vickery) - Joe Hertz
Louder - Drunken Masters feat. Portugal. The Man
Setting Fires (it's different Remix) - The Chainsmokers feat. XYL\u00d8
Breathe A\u00b7gain - Couros
Gamesofluck - Parcels
Swedish Guns - The Radio Dept.
I Would - KAN WAKAN
I Want Your Love (feat. Bryn Christopher) - Jenaux
Closer (ARMNHMR Remix) - The Chainsmokers feat. Halsey
Front to Back - Buku
Wannabe (feat. Jon Santana) - CAPPA
Hypnotic - Zella Day
Always - Great Good Fine Ok
Windows feat. Prof - Atmosphere
Flume feat. Kai - Never Be Like You (Tyson Kraft Remix)
Closer feat. Bishop (Virtu Remix) - Elephante
Things (Taylor Wise Remix) - Maggie Lindemann
Sober (Oliver Nelson Remix) - Childish Gambino
The Mother We Share - CHVRCHES
Roses & Money (3LAU Mashup) - The Chainsmokers vs DJ Snake vs Lil Dicky
Woman - HONNE
Untouchable (Proppa Remix) - Tritonal & Cash Cash
Memory Lane (Sittin' In Da Park) - Nas
Branches - Chrome Canyon
Unstoppable - Paperwhite
Man Without Shadow - Breakbot
Loud Places (CLOUDCHORD Remix) - Jamie XX
Evolve - Imagined Herbal Flows
Don't Fight It - Gavin Turek
Waiting - Oliver Heldens & Throttle
Say Anymore - kiiara
RGF ISLAND - Fetty Wap
Trap Queen (Rough) - Fetty Wap
Ocean Eyes (Astronomyy Edit) - Astronomyy
Paris (Louis The Child Remix) - Magic Man
Let It Whip (Rayko edit) - The Daz Band
Home - ISLANDIS
Kamikaze - _M\u00d8_
Bloodsport (Hurley Mower Remix) - Raleigh Ritchie
Open Season (Gryffin Remix) - Josef Salvat
Threads - Izzard & Blankts
Froot - Marina And The Diamonds
Froot (Oliver Nelson Remix) - Marina And The Diamonds
Froot (St. Lucia Remix) - Marina and The Diamonds
Slumlord - Neon Indian
Gold (Snakehips Bootleg) - Bondax
Good Times Roll - GRiZ x Big Gigantic
Master Blaster (Jammin') - Stevie Wonder
Annie - Neon Indian
Summer '97 feat. Muzzy Bearr - GRiZ
3 Bricks (Phoniks Remix) - Wu-Tang Clan feat. Biggie Smalls
For the Love (Autograf Remix) - GRiZ feat. Talib Kweli
Them Changes - Thundercat
Nothing Left (feat. Will Heard) - Kygo
So Good - Beat Connection
Look Over Your Shoulder (Produced by SOHN) - Kwabs
Somewhere To Run (Lost Kings Remix) - Krewella
Ignite - RKCB
Walk With Me (feat. KU\u010cKA) - Cosmo's Midnight
High Love - Dim Sum
Scud Books - Hudson Mohawke
Roses feat. Rozes (Original Mix) - The Chainsmokers
Frontline - Gavin Turek
Are You That Somebody? - Aaliyah
Found Your Love - Oliver Nelson feat. Heir
The Buzz feat. Mataya & Young Tapz - Hermitude
Sake - Jupiter
One o Six (A.N.D.Y. Remix) - Jupiter
Do It - Jupiter
HIGH - SIVIK
Long Way Down (Sean Glass Remix) - Robert Delong
Coco (Flosstradamus Remix) - O.T. Genasis
Saturday Love - Zimmer x Pallace
Temporary Love feat. Brooke Forman - Elephante
Hopeless - LEA SANTEE
For The Love (feat. Talib Kweli) - GRiZ
Secrets(Original Mix - Tiesto & KSHMR feat. VASSY
ferrari - coyote kisses
King Kunta - Kendrick Lamar
Sunday Candy - Donnie Trumpet & The Social Experiment
Coastal Love - HONNE
Talking Body (The Young Professionals Remix) - Tove Lo
Cry Me A River (Deficio Remix) - Justin Timberlake
To \u00dc (Feat. AlunaGeorge) - Skrillex And Diplo
Save Tonight (Nigel Good Remix) - Louis Vivet
Technicolour Beat - Oh Wonder
Lean On (feat. M\u00d8) - Major Lazer & DJ Snake
Runnin' (Bit Funk Remix) - The Pharcyde
The Blacker The Berry (Prod. by Boi-1da) - Kendrick Lamar
Pay No Mind (feat. Passion Pit) - Madeon
Tribe (NGHTMRE Remix) - Theophilus London
Levitation (That's Nice Remix) - Marz Leon
White Light - Waterstrider
Calling Up On A Tuesday (ILoveMakonnen & Drake x Penguin Prison) - The Hood Internet
Years Of War (Golden Features Remix) - Porter Robinson
Dear Mama (Boehm Remix) - 2Pac
revive - coyote kisses
Something About You - Hayden James
Make Me Fade - Vanic X K.Flay
Sound Check - Gorillaz
Lord Pretty Flacko Jodye 2 (PFJII) (prod. Nez & Rio) - ASAPMob
Paper Planes (Eau Claire Remix) - MIA
Let's Love Baby - Kulkid
G.O.M.D. - J. Cole
I'm Into You - Chet Faker
1998 - Chet Faker
Illuminate feat. Years & Years (MJ Cole Remix) - TOURIST
Twenty Eight (Nightizm Remix) - The Weeknd
A Fine Way To Die feat. Orlando Napier - GRiZ
Beggin For Thread (Gryffin & Hotel Garuda Remix) - BANKS
Heartbeat - Childish Gambino
Down With The Trumpets (Star Slinger Remix) - Rizzle Kicks
Down With The Trumpets - Rizzle Kicks
We Are The People - Empire Of The Sun
DNA - Empire Of The Sun
With You (Jai Wolf Remix) - Dirty South
03 Oliver Veut Te Voir - Elocnep
Still Blazin - Wiz Khalifa
Never Been - Wiz Khalifa
Runaway (U & I) (LBCK Remix) - Galantis
Fuck The World (Prod. by Jae Faive & 6ix) - C Dot Castro
Girls (MOORS Remix) - Slow Magic
Wandering Star - Empire Of The Sun
Strawberry Letter - Brothers Johnson
Lazy Love - The Geek x Vrv
Xenogenesis - TheFatRat
Cool Kids (RAC Mix) - Echosmith
Hello Vs. Party & Bullshit (Matoma Remix) - Matoma
Runaway (U & I) (Lash Remix) - Galantis
Forgot About Dre (niceFingers Remix) - niceFingers
Thank You - R\u00f6yksopp
Dead Air - CHVRCHES
All I Want (Manila Killa Remix) - Dawn Golden
Sunshine feat. Reggie Watts - Flight Facilities
Not Today - Chill Bump
Weekend (Oliver Nelson Remix) - Priory
Chimes (Official) - Hudson Mohawke
Don't Hold Back - Chanson
Giving Up - HAERTS
Hemiplegia (Avec Sans Remix) - HAERTS
No One Needs To Know - HAERTS
Forgive - Pr0files
Superstitions - Misun
Victory (feat. EVVY) - Sound Remedy
Break The Mold (Smash Mouth v. French Kiwi Juice) - Ricky Cervantes
Am I Wrong (The Rooftop Boys Remix) - Nico & Vinz
Don't Wanna Dance (Goldroom Remix) - M\u00d8
Borderline - Tove Styrke
Kanye (K Theory \Kanye Told Us To\ Remix) - The Chainsmokers
Let It Be (TORN Remix) - Labrinth
Love Game (feat. Kendrick Lamar) - Eminem
Business (Matoma Remix) - Eminem
Won't Look Back (Disco Fries & Aylen Remix) - Duke Dumont
Fade feat. Zak Waters - Adventure Club
Dangerous (Oliver Remix) - Big Data
Real Love - Clean Bandit & Jess Glynne
King Night - Salem
Unbreakable (Elephante Remix) - Dirty South
Toxins - Mating Ritual
Nara - alt-J
Big City Life (LEEX Remix) - Mattafix
i - Kendrick Lamar
Classic (feat. Powers) - The Knocks
Fancy (Brooks Brown Remix) - Iggy Azalea feat. Charli XCX
Life's What You Make It - Talk Talk
Inferno feat. Lizzy Plapinger of MS MR - Sir Sly
2 On (TOKiMONSTA remix) - Tinashe feat. Schoolboy Q
Beloved (Tiedye Remix) - Say Lou Lou
Everything We Touch (Yannis remix) - Say Lou Lou
Feels Like We Only Go Backwards (Tame Impala Cover) - Say Lou Lou
Crave You feat. Giselle [OFFICIAL] - Flight Facilities
The Friendly Sound - Lemaitre
100HM - Hudson Mohawke
Thunder Bay - Hudson Mohawke
Sexotheque - La Roux
drunk n luv (diplo remix) - diplo
Look At Where We Are (Major Lazer Remix) - Hot Chip
Be My Baby feat. Cashmere Cat (Edit) - Ariana Grande
Pyramid Building - Hilltop Hoods
Superfast Jellyfish (Feat. Gruff Rhys and De La Soul) - Gorillaz
Rhinestone Eyes - Gorillaz
On Melancholy Hill - Gorillaz
Rich Girls (The Twelves Remix) - The Virgins
Wait (Elephante Remix) - Lemaitre
Coucheron \u201cDeep End\u201d feat. Eastside & Mayer Hawthorne (Matoma Remix) - Matoma
Don't Shoot (feat. Rick Ross - The Game
Freeway (Kill The Noise & Flux Pavilion Remix) - Flux Pavilion
Rude (Zedd Remix) - Magic!
Don't (Remix) feat. Rick Ross - Ed Sheeran
Only Lover (JNL's Monogamix) - Soft Touch
Primadonna (Skogsr\u00e5 Remix) - Goldbass
Higher (Oliver Nelson & Skogsr\u00e5 Remix) - Tobtok feat. Emil Her\u00f3
bad_news - BASTILLE
Forgive & Forget (Oliver Nelson Remix) - The Kooks
Paranoia - SAFIA
Love Sex Magic (Axmod Remix) - AxMod
Fancy (Milk N Cookies Remix) - Iggy Azalea
West Coast (Coconut Records Cover) - MAINLAND
East Of Eden (SteLouse Remix) - Zella Day
Often - The Weeknd
East of Eden - Zella Day
Leave Your Love - Young Summer
Self Control - KATE BOY
East Of Eden (Carousel Remix) - Zella Day
Make It Bun Dem (Dead Battery Remix) - Skrillex & Damian Marley
Often (Kygo Remix) - The Weeknd
Make You Mine - Breakbot
Wait feat. LOLO - Lemaitre
Couch Potato - Jakubi
Jealous (Funk LeBlanc Remix) - Chromeo
Dollhouse (One Love Remix) - Melanie Martinez
Kids (Teka's Rub-A-Dub Remix) - Marteria
Drop It Like It's Hot (Tim Gunter Remix) - Snoop Dogg
Lemaitre- High Tide (Oliver Nelson & Tobtok Remix) - Lemaitre
Old Thing Back (Matoma Remix) - The Notorious B.I.G feat. Ja Rule
Deep End feat. Eastside and Mayer Hawthorne - Coucheron
GHOST - chelsea lankes
I Want U - Alison Wonderland
Hard Time - Seinabo Sey
The Life Feat. Penguin Prison - Viceroy
1965 (4AM Reboot) - Zella Day
Wrong Club (Club Mix by The Super Criticals) - The Ting Tings
Curtains - Last Lynx
Team - Lorde
Tennis Court - Lorde
Girl - Jamie xx
Faded (Steve James Remix) - ZHU
Harder - Daft Punk
It's Too Late (Snakehips Remix) - Wild Belle
Keystone State of Mind - Tayyib Ali
Steal Eastwood - The White Panda
Rich Girls (Le Castle Vania's Spring Break No Parents Remix) - The Virgins
Make Some Noise - Beastie Boys
Pools - Glass Animals
It's Just A Ride - Gramatik
Younger (20syl Remix) - Seinabo Sey
Like I Love You - Le P
Goldbass \u2014 Primadonna (Skogsr\u00e5 Mix) - SKOGSR\u00c5
Ways to Go - Grouplove
Green Gardens (Djemba Djemba Remix) - Laura Mvula
History - Le P
Aint Nobody (Chaka Khan Cover) - Le P
Shooting Stars - Bag Raiders
Open Wound (ODESZA Remix) - KiTheory
Rescue - Trust
Where Nobody Knows Your Name - Flyte
Sweetness Alive (Wax Nostalgic Remix) - Goldroom
Gimme the Loot Remix (feat. RJD2) - The Notorious B.I.G.
D.A.N.C.E (Paste Black Remix) - Justice Vs Data
We Left (Ride The Universe Remix) - R\u00dcF\u00dcS
Sundream (Hayden James Remix) - Rufus
Sundream (Wordlife Remix) - RUFUS
Team (Elephante Remix) - Lorde
White Noise (cln remix) - Disclosure
I Think I Like You - SIRENXX
You Had My Mind - Free n Losh
7th Dimension - KOAN Sound
Find You (Flaxo Remix) - Zedd
Helix (Lazerdisk Party Sex Remix) - Justice
Do You Even Know? - Rae Morris.
Atmosphere (Instant Party! Festival Remix) - Kaskade
Get A Grip Feat. Gibbz - Gramatik
Liar Liar (We Are Nuts! Edit) - Cris Cab
Comme Un Enfant (Viceroy Remix) - Yelle
Que veux-tu - Yelle
Embrace (Go Go Bizkitt! Remix) - Goldroom
Swing Into It feat. HAERTS (Chordashian Remix) - French Horn Rebellion
Falling For You (Original Mix) - L'\u00c9tranger
Slow Burn - Palace
Idea of Happiness (Robotaki Remix) - Van She
Breaking the Angle Against the Tide - Craft Spells
Just Like Heaven (The Penelopes Remix) - The Cure
Moths - Racing Glaciers
When You Were Young (The Soundmen Remix) - The Killers
Que Veux Tu (Madeon Remix) - Yelle
Pardon My French - Gramatik
Bennie & The Jets - Miguel feat. Wale
Are You That Somebody? (Aaliyah Cover) - Banks
You're Not The One (Cid Rim Remix) - Sky Ferreira
Dont be Shy (La Felix remix) - Dcup
Someone Told Me (La Felix Remix) - DCUP
Skinny Love (Vanic Remix) - Vanic Official
Purple Yellow Red and Blue (Muneshine Remix) - Portugal. The Man
Lanes (feat. A$AP Rocky & Phantogram) 2 - Big Boi
The Moss - Cosmo Sheldrake
All That She Wants (Self Help & Tanner Re-Twerk) - Ace Of Base
Forgot About Dre (The Golden Pony Remix) - Dr. Dre
Summer - Calvin Harris
Paris (Nicita Remix) - Magic Man
The Man - Aloe Blacc
Recess (feat. Kill The Noise & Fatman Scoop) - Skrillex
Everything We Touch - Say Lou Lou
Need You Feat. Blu - L'Orange
Jealous (I Ain't With It) - Chromeo
Transatlanticism (Collin McLoughlin Remix) - Death Cab for Cutie
In Your Bed (Oliver Nelson Remix) - Ariana & The Rose
Come On To Me (feat. Sean Paul) - Major Lazer
Hideaway - Kiesza
FOREVA - GOODBYE CHANEL
Red Light - Eddie Murphy feat. Snoop Lion
When You Were Young (Calvin Harris Remix) - The Killers
Hanging On (I See MONSTAS Remix) - Ellie Goulding
I Didn't Believe (Special Features Remix) - Flight Facilities
Don't Wanna Dance (Flip Remix) - M\u00d8
Feed Me Diamonds (Oliver Nelson Remix) - MNDR
Fuckable (feat. Baghdaddy) - Hot Sugar
Feel Good Inc - Gorillaz
Say You'll Be There - M\u00d8
Smooth Operator - Sade
When Am I Going To Make A Living (Poolside's Tons of Drums Edit) - Sade
I Am Not A Robot (Penguin Prison Remix) - Marina & The Diamonds
Voyage Voyage - Desireless
Everyday Struggle (Dead Battery Remix) - The Notorious B.I.G.
December 4th (Sourface Remix) - Jay-Z
Gossip (Feat. UGK & Big K.R.I.T.) - Big Boi
Generate Some Action \u2022 (Preview) - Fatback 4Way feat. Don Dolla
GossipZilla - Big Boi feat. Big K.R.I.T. & UGK & Blue Oyster Cult
Julian (The Chainsmokers Remix) - Say Lou Lou
drive me wild - Young Yeller
Get Free feat. Amber of Dirty Projectors (Blood Diamonds Remix) - Major Lazer
Get Free (Vacationer Remix) - Major Lazer
Get Free (feat. Amber of Dirty Projectors) - Major Lazer
Medicine (Sound Remedy Remix) - Daughter
Almost Home (Washed Out Remix) - Moby
Sea Of Dreams (Turbotito Remix) - Baby Alpaca
Like I'm On Fire (Kartell Remix) - Karma Kid
September - Earth Wind and Fire
Assembly - Elephant
Elusive Youth - Elephant
Holding On For Life - Broken Bells
Suit & Tie (Oliver Nelson Remix) - Justin Timberlake
With Your Suit & Tie On (Marvin Gaye vs Justin Timberlake) (No Rap Version) - RRodd
Cut Your Teeth (Kygo Remix) - Kyla La Grange
Night By Night (Oliver Nelson Remix) - Chromeo
somethin - MVSCLES
Untrust Us - Crystal Castles
Centred On You (Viceroy Remix) - Atlas Genius
Spinning Signs - Painted Palms
Will Calls (Diplo Remix) - Grizzly Bear
Done Wrong (Opiuo Remix) - Pretty Lights
Permission To Love - Hayden James
Build Me Up (Feat. O.D.B.) - Rhymefest
Without You Feat. Totally Enormous Extinct Dinosaurs (Chordashian Remix) - Dillon Francis
F.H.H (Feat. Jakki Da Motamouth) - RJD2
Come Alive (feat. Toro y Moi) - Chromeo
With Me (Stwo Edit) - Cashmere Cat
Top Of The World feat. Big Sean (prod Diplo & Benny Blanco) - Mike Posner
Younger (Kygo Remix) - Seinabo Sey
Binary Suns (Coyote Kisses Remix) - Star Wars
Retro City - Adventure Club
Wait - Adventure Club
Crave You (Adventure Club Dubstep Remix) - Flight Facilities
Flying - Grandtheft & Smalltown DJs
Biggie Smalls feat. Method Man (Phoniks Remix) - The What
Real Hip Hop (Phoniks Remix) - Das EFX
C.R.E.A.M. (Phoniks Remix) - Wu-Tang Clan
runaways - Mirror Kisses
Boulevard Malesherbes - Moustache Machine
Something about us (Daft Punk Cover) - Moustache Machine
Porquerolles - Moustache Machine
Cut This - Younker
Love Me Like You - Ella Eyre
Is This Love (Montmartre Remix) - Bob Marley
A Troubled See - Girls Names
Hypnotic Regression - Girls Names
Rather Be Feat. Jess Glynne - Clean Bandit
Younger - Seinabo Sey
No Diggity vs. Thrift Shop (Kygo Remix) - Ed Sheeran & Passenger
Can't Afford It All (Kygo Remix) - Jakubi
I See Fire (Kygo Remix) - Ed Sheeran
Atlas Hands (AA 'Touch The Sky' Bootleg) - Thomas Jack
Stand Still (feat. Micky Green) - flight facilities
No Diggity - Chet Faker
I'm Corrupt - DCUP
Killing Switch - Last Lynx
Hold On When You Get Love And Let Go When You Give It - Stars
New Scene (CRNKN Remix) - Felix Cartal
Bad Girls (Gigamesh Remix) - Donna Summer
Wu-Tang's Maneater feat. Hall & Oates & Wu-Tang Clan - The Melker Project
Augenbling - Seeed
The Feeling (Dave Edwards Remix) - The Knocks
Dancing With The Dj - The Knocks
You're Not Good Enough - Blood Orange
Technicolor (Original) - Madeon
Girls (The Knocks remix) - The 1975
Ghostbusters (Kill Paris Remix) - Kill Paris
Wine Glass Woman (Aeroplane Remix) - Mayer Hawthorne
Scared - NONONO
Obviously (Feat. Cherub & Exmag) - Gramatik
Sparks - F U R N S
We Must Drop It Like It's Hot (Snoop Dogg & Pharrell x Pretty Lights) - Lazenbeats
Who Am I (What's My Name)? - Snoop Doggy Dogg
Enchanted Land - THE MAGICIAN
A Real Hero (feat. Electric Youth) - College
No Diggity (The Polish Ambassador Remix) - Blackstreet
Gold feat. Yuna - Adventure Club
Wonder Feat. The Kite String Tangle - Adventure Club
SHEKNOWSHEBAD - heRobust
Pyramidspeak (Purity Ring vs Frank Ocean) - The Hood Internet
Over Your Head (B.o.B & 2 Chainz vs Chromeo) - The Hood Internet
Kangaroo Court (Forever Kid Remix) - Capital Cities
Electric Feel (Kygo Remix) - Henry Green
Awake - Tycho
HERE WE GO AGAIN - Johnny Stimson
Modern Jesus - Portugal. The Man
Cloudbusting (Kate Bush Cover) - Wild Nothing
Hounds Of Love - Kate Bush
Cloudbusting (Kate Bush Cover) - Geographer
Waves That Rolled You Under (backstroke Remix) - Young Summer
Trying To Be Cool (The Chainsmokers Remix) - Phoenix
Don't Let Me Down - The Melker Project
Applause (Viceroy Remix) - Lady Gaga
I Was A Fool - Tegan and Sara
I Was A Fool (Monsieur Adi Remix) - Tegan And Sara
Tennis Court (Lorde Cover) - The Kite String Tangle 
Girls (feat. JD Samson and Fat Tony) - French Horn Rebellion
This Moment - French Horn Rebellion
Love Is Dangerous ( Killy Cakes Remix ) - French Horn Rebellion
The Mother We Share (Moon Boots Remix) - CHVRCHES
Delta - C2C
Liar Liar - Avicii
i need a dollar (chrome remix) - Aloe Blacc & Wu-Tang Clan (YUM YUM)
Over Your Shoulder - Chromeo
Isosine - Anna Kendrick
Crazy Bird - Wild Child
Don't You Want Me (The Human League Cover) - French Horn Rebellion
Bit By Bit - Mother Mother
All I Have - fuckmylife
Science - Future Feelings
Waves That Rolled You Under - Young Summer
Hayloft - Mother Mother
Talking Heads - This Must Be The Place L'Equipe du Son Rework - L'Equipe du Son
Believe - The Nights
Doo Wop (That Thing) - Quantic y Anita Tijoux
Miss You (Glenn Dale's Rework) - The Rolling Stones
Spectrum (Comic Strips Remix) - Zedd
Trying To Be Cool feat. R Kelly - Phoenix
Ways To Go (Grandtheft Remix) - Grouplove
Dust Clears (Radio Edit) - Clean Bandit
Holiday - jakubi
Too Young For Love - Superhumanoids
URGENT (LUXXURY EDIT) - FOREIGNER
Electricity - FMLYBND
All The Days - HAERTS
Treasure - Bruno Mars
Primadonna (Mr. Larsson Remix feat. DANGA) - Marina and the Diamonds
Primadonna - Marina and the Diamonds
I Know The Truth - Pretty Lights
Dark Star (Kiely Rich Remix) - Jaymes Young
Electric Feel - MGMT
Young and Beautiful (No Pets Allowed Dubstep Remix) - Lana Del Rey
The Feeling (Peter Thomas Remix) - The Knocks
NO DIGGITY (BONDAX EDIT) EQ'D (DKS) - Blackstreet
Operate (The Chainsmokers Remix) - ASTR
Dreams (Gigamesh Edit) - Fleetwood Mac
Give Life Back To Rapper's Delight (Daft Punk x Sugarhill Gang) - Elocnep
Farrah Fawcett Hair (feat. Andr\u00e9 3000) - Capital Cities
Dancing In September (Troika Mashup) - Porter Robinson  Earth Wind & Fire  Gary Go  Empire Of The Sun  JackLNDN
Doin' It Right (feat. Panda Bear) - Daft Punk
Julian (Monsieur Adi Remix) - Say Lou Lou
Summertime Sadness (Prod. Ryan Hemsworth) - A-1
Gold (Moon Boots Remix) - Bondax
Off My Mind (Rogue Vogue Remix) - Moon Boots
Discovery Megamix bootleg - Daft Punk
Sexual Healing - Hot Chip
All Night (Nico Pusch Bootleg Remix) - Parov Stelar
Bonafied Lovin' (The Third Remix) - Chromeo
A Baru In New York feat. Gurrumul (Flume Soundtrack Version) - Yolanda Be Cool
Digital Love (Panic City Remix) - Daft Punk
Designer Drug - Mayer Hawthorne
Random Access Memories (Vanderway Edit) - Daft Punk
Peanuts - Breakbot
Too Young (Penguin Prison Remix) - Ghost Beach
Too Young To Die - Jamiroquai
  - Parov Stelar - Libella Swing (Tantric Decks Re-Rub)
I Am Not A Robot (Passion Pit Remix) - Marina and the Diamonds
Oh No! (Grum Remix) - Marina and the Diamonds
Down On Life - Elliphant
Careless whisper - Wham! & George Michael
Pompeii (Monsieur Adi Remix) - Bastille
High For This - Ellie Goulding
The Road - A Tribe Called Red
Slow Down (PIXELATED 2012 End of the World REMIX) - Poolside
Jasmine - Jai Paul
Smash Dem Brains In - Caligola
Green Jester - Nam Nori & Jordan Viviant
NO ANGELS - BASTILLE
West 7th - Comanche
Off My Mind - Moon Boots
Obedear - Purity Ring
Overtime - Cash Cash
She was feat. Birds of Paradise - Seven Lions
Mother Protect (Goldroom Remix) - Niki & The Dove
Beaches and Friends (Hey Champ Remix) - French Horn Rebellion vs. Database
Love is Dangerous (Chrome Canyon Remix) - French Horn Rebellion
Evil Woman (Remix feat. ELO) - Hoodie Allen and Mike Posner
Gangnam Busters (Faroff Mash-up) - Psy vs Ghostbusters
GANGNAM STYLE (\uac15\ub0a8\uc2a4\ud0c0\uc77c) - PSY
Billie Jean - Michael Jackson
Karma Police (Radiohead cover) - Easy Star All-Stars
Hollywood (feat. Penguin Prison) (Cassian Remix) - RAC
Gettin' Jiggy Wit it (Viceroy \Jet Life\ Remix) - Will Smith
Be Alright - Zapp & Roger
More Bounce to the Ounce (jOBOT rmx) - Zapp and Roger
Computer Love - Zapp & Roger
We Can't Fly (Oliver Remix) - Aeroplane
Back Seat (Goldroom Remix) - Atlas Genius
Lying Together - French Kiwi Juice
Float (TheFatRat Remix) - Pacific Air
Sohight & Cheevy - You Never Know (Original mix) - Sohight & Cheevy
Bug Hunt (Noisia Remix) - Skrillex
AFFECTION - Crystal Castles
Mind Controller by Ayah Marar (Cutline Remix) - Cutline
Bonafied Lovin (RAC Mix) - Chromeo
Language (JackLNDN Edit) - Porter Robinson
You Make Me Feel Good - Satin Jackets
I'm Just Me - Diamond Rings
Red Lines - S O H N
Feels So Good - Chuck Mangione
Barely Love You Too (HiDeaf vs Halatrax Remix) - Frank and Derol
Do You Need Someone (Kill Paris Remix) - Beth Ditto
Too Close (Bring The Noise Remix) - Alex Clare
Trojans (Lenno Remix) - Atlas Genius
I'm Corrupt (Viceroy Remix) - DCUP
Get Free (Adriatique's Lazers Never Die Rework) - Major Lazer
All I Need (Submatik Remix) - Virtual Riot
6 More Weeks (Chrome Canyon Remix) - Erika Spring
All Eyes On You (Chrome Canyon Remix) - St. Lucia
Winter Is All Over You (Baauer Remix) - First Aid Kit
Fn Pig - Joel Zimmerman
Suspended in Gaffa (feat. Phoebe Oglesbee) - Chrome Canyon
No Strings (RAC Remix) - Mayer Hawthorne
Pushing (Original Mix) - Disfunktion feat. Jennifer Cooke
Fat Lip (Acetronik Remix) - Sum 41
Every Little Gambino She Does Is Childish - 8corporation Mashup - Childish Gambino feat. Bon Iver
Billy Jack (Chip Chabralle's Blissed Up Work Out) - Curtis Mayfield
Night by Night (Shreddie Mercury Remix) - Chromeo
Don't Let Me Down 2012 - Gramatik Vs. The Beatles
Cry (Just A Little) (Tobtok Remix) - Bingo Players
Dillon & NOLA - Diplo feat. Nicky Da B X Dillon Francis - Sage Franz
Falling Down (Kaptain Bootleg Remix) - Sub Focus
Sugar - Moon Boots
In For The Kill (Skrillex Remix) - La Roux
Sunset Funk (MP's 'Sweet Disposition' Edit) - MAM
Acceptable In The 80s - Calvin Harris
Lights - Ellie Goulding
Icarus (Extended Mix) - Madeon
The Island (Madeon Remix) - Pendulum
Minimix (Annie Mac Radio 1) - Madeon
Healthy Ego - Left Boy
H8 (3LAU Bootleg) - 3LAU
Ain't My Style (feat. John Turrell) - Featurecast
Do You Disco - Dads On Display
Change (5 & A Dime Bootleg) - Dillon Francis & Diplo ft. Porter Robinson
Catgroove - Parov Stelar
Monday (The Glitch Mob Remix) - Nalepa
Drive It Like You Stole It - The Glitch Mob
Silhouettes (Disco Fries Remix) - Avicii
Bonfire - Childish Gambino
We Ain't Them - Childish Gambino
Rogue - Air (Summer Chords) - Rogue
Green Eyed Love (Classixx Remix Instrumental) - Mayer Hawthorne
Exceeder (Felguk Remix) - Mason
One Out Of Two (feat. Irfane) (Oliver Remix) - Breakbot
Killin' It - Krewella
Idea Of Happiness - Van She
Idea Of Happiness (SebastiAn Remix) - Van She
Lose my breath (Reggae remix) - Destiny's Child
Call Me Maybe (Coyote Kisses Remix) - Carly Rae Jepsen
Call Me Maybe (DJ BMILK For You Bootleg) - Carley Rae Jepsen x Madeon
Call Me Maybe Vs. 99 Problems (Scott Melker and Friendly Greg Popped And Screwed Remix) - Carly Rae Jepsen Vs. Jay-Z
Not in Love - Platinum Blonde
Spirit Of The Night - Tesla Boy
Take A Walk (Peking Duk Remix) - Passion Pit
Everybody Wants To Rule The World - SirAiva (We Rule Remix) Tears For Fears
Arcadia - FAIRCHILD
Money Makin' - A-Trak & Dillon Francis
Next To You - Dante
Pv Nova - My Pryde (Mattanoll Remix) - Pv Nova
Night Mania (Carlos Serrano Mix) - Phoenix vs. Kavinsky
Do I See Color (Big Gigantic Remix) - Adventure Club
Dance On You - Mr. Gonzo
Shades of Funk - Kill Paris
IPC - Light Asylum
The Smurf - Tyrone Brunson
When The Night Falls - Chromeo
Sweet Sensation (Cyclist Dub Edit) - Sharon Redd
Stray Cat Boogie (Ichisan remix) - Sneak Thief
Hot New Jam from '73 - Fresh Millions
Intergalactic - Beastie Boys
Friendly City - Milo & Otis
Work To Do - The Isley Brothers
Lost Woods (Ephixa Dubstep Remix) - Zelda
Digital Love - Sabrepulse
Fire Hive (Krewella fuck on me remix) - Knife Party
Nothing Gold (Todd Terje mix) - JOAKIM
Inspector Norse (radio edit) - TODD TERJE
Daphnis The Nymph - Lancelot
Baby Be Night (Ugly Kids Mash) - Breakbot Vs Chromeo
Return Of The Mack (Viceroy \Jet Life\ Remix) - Mark Morrison
Ruffneck (Alvin Risk Remix) - Skrillex
Henny & Gingerale - Mayer Hawthorne
Kangaroo Court - Capital Cities
No Interruption - Hoodie Allen
When The Night Knows (Whitney Houston x Chromeo) - The Hood Internet
Wolfgang Gartner - Push and Rise(PrototypeRaptor Bootleg Remix) - PrototypeRaptor
Renegade (Vindata Remix) - Wynter Gordon
Still Sound (Vindata Remix) - Toro Y Moi
What's My Noise (Snoop Dogg vs Dillon Francis & Kill The Noise) - The Hood Internet
Boogie Wonderland - Earth Wind And Fire
Paradise - Sabrepulse
Do It Again - Rebirth Brass Band
This Head I Hold - Electric Guest
Somebody That I Used To Know (KDrew Remix) - KDrew
Dill The Noise - Dillon Francis & Kill The Noise
Nightchain (Wale vs Kavinsky) - The Hood Internet
Next Levels (TheFatRat Remix) - Avicii
Must Be The Feeling (Delta Heavy Remix) - Nero
Head Over Heels - Tears For Fears
Angeles - Goldroom
Daft Punk Live Edit - Betatraxx
Youth (Love Thy Brother Remix) - Daughter
Do I See Color - Adventure Club
Get Down On It (Alexandre Louvr\u00e9 Remix) - Kool & The Gang
Do Ya Think I'm Sexy? - Rod Stewart
Mr. Saxobeat - Alexandra Stan
Midnight City (Christian Strobe Remix) - M83
Just for Now (Gosteffects & Rule of Eight \I'm God\ Remix) - Imogen Heap
Shades Of Black - Breakbot
Mr Blue Sky - Mayer Hawthorne
Turn It Down (With Rebecca & Fiona) - Kaskade
Cherub - Love You Right (Cry Wolf Remix) - Cry Wolf
Goodbye Stranger - Supertramp
Strawberry Letter 23 - Shuggie Otis
Steve McQueen - M83
Throwing Fire - Ronald Jenkees
Night Like This In Georgia - G.C. Cameron
Boogie Wonderland (Skibblez 'Space Boogie' Remix) - Earth Wind & Fire
Let's Groove - Earth Wind And Fire
September (One Love Bootleg) - Earth
ID - Avicii & Nicky Romero
Excuse Me - Lema\u00eetre
Bluebird - Odjbox
The Only One - Odjbox
You Make My Dreams - Hall & Oates
Night By Night - Chromeo
Don't Turn The Lights On (Chromeo Cover) - Mayer Hawthorne
Hot Mess (23 Dubstep Remix) - Chromeo
Don't Turn The Lights On (Aeroplane Remix) - Chromeo
Natural Energy - Comanche
Acapulco Gold - Comanche
Phantoms - Comanche
Moose Knuckle - Comanche
Golden Train - Penguin Prison
OooO - Dreams.
Happy Violence (Caveat Remix) - Dada Life
ID (HQ Preview) - Avicii
Fancy Footwork - Chromeo
When The Night Falls (Breakbot Remix) - Chromeo
When The Night Falls (Sammy Saxy Bananas Remix) - Chromeo
Don't Walk Away - Chromeo
Don't Turn The Lights On - Chromeo
The Walk - Mayer Hawthorne
Beam Me Up (Jacques Renault Remix) - Midnight Magic
He's The Greatest Dancer - Sister Sledge
I.D.G.A.F.O.S. - Dillon Francis
San Diego VIP - Skrillex
Rawnald Gregory Erickson The Second - Starfucker
Robotic Love (Lenno Remix) vs Harder Better Faster Stronger (Cosmonaut Grechko Mash-Up) - Labtracks vs Daft Punk
Blue Jeans (PatrickReza Dubstep Remix) - Lana Del Rey
Sweet Disposition (Axwell & Dirty South Remix) - The Temper Trap
Syndicate - Skrillex
75' Times Harder (Jimi Needles Blend) - Daft Punk vs Fort Knox 5
Helena Beat (Jimi Needles Re-Rub) - Foster The People
Tommy's Theme - Noisia
Tarantino - Dirtyphonics
Stevie Wonder  My Eyes Don't Cry (Sergio & Allen Craig Tears Of Joy Edit) - sergioaudio
Quicker (Shook Remix) - I Blame Coco
The Worse It Gets (Shook Remix) - Penguin Prison
The Race - Xtrafunk
Your Boy Is Back - Sweater Beats
Superstition (Funkanomics Remix) - Stevie Wonder
Loist-Moinal - Opiuo
No Strings (Prod by Classixx) - Mayer Hawthorne
This Party - Das Tapes
Black Ferrari (Single) - Das Tapes
We Love (The 14th Minute Remix) - Sneaky Sound System
P.Machinery (Polish) - Propaganda
Everything to me (Christian Strobe Remix) - Lips
A Long Time - Mayer Hawthorne
Canned Heat (Calvin Harris Remix) - Jamiroquai
A Long Time (Chromeo Remix) - Mayer Hawthorne
Hot Mess - Chromeo
Express (Original Mix) - Janski
Psychedelic Stereo - Mimosa
Up & Down I Go - Pretty Lights
Foreign Language (feat. Jess) - Flight Facilities
When the Night Falls (feat. Solange Knowles) (Chromeo Cover) - Mayer Hawthorne
Warrior Concerto - The Glitch Mob
Banana Ripple - Junior Boys
Bizarre Love Triangle - New Order
The Worse It Gets - Penguin Prison
Multi-Millionaire (Shook Remix) - Penguin Prison
Worse It Gets (RAC Mix) - Penguin Prison
Bonafied Lovin' (LA Riots Remix) - Chromeo
Midnight City - M83
Bizarre Love Triangle (Richard X Extended Remix) - New Order
Zimbabwe - New Navy
Double Life Of Mau5e (Skrillex Mix) - Deadmau5
Somebody That I Used To Know - Gotye
Roxanne (DiscoTech Remix) - The Police
Baby I'm yours feat. Irfane - Breakbot
Monkey Crunk MP3 - Opiuo
Where You'll Stay - Falcon Punch
Pumped Up Kicks (Gigamesh Remix) - Foster The People
Houdini (RAC Remix) - Foster The People
International Whisperer's Anthem (Skratch Bastid's Sexy Sax Mix) - UGK
Climbing Walls - Strange Talk
You Can Dance - Chilly Gonzales
Isn't She Lovely - Stevie Wonder
Living For The City - Stevie Wonder
Girl And The Sea (Cut Copy Remix) - The Presets
Green And Yellow - Lil Wayne
Beyond Right Now (The Glitch Mob Remix) - STS9
What the Fuss? (Shook Remix) - Q-Tip f. Stevie Wonder
You Are My Vision (Original) - Night Drugs
New Noise (Haydn Hoffman Remix) - The Bloody Beetroots
